{
    "width": 50,
    "height": 50,
    "data": [
        [15,15,15,15,15,15,15,15,15,15,15,15,15,15,15,15,15,15,15,15,15,15,15,5,6,6,7,15,15,15,15,15,15,15,15,15,15,15,15,15,15,15,15,15,15,15,15,15,15,15],
        [15,15,15,15,15,15,15,15,15,15,15,15,15,15,15,15,15,15,15,15,15,15,15,5,6,6,7,15,15,15,15,15,15,15,15,15,15,15,15,15,15,15,15,15,15,15,15,15,15,15],
        [15,15,15,15,15,15,15,15,15,15,15,15,15,15,15,15,15,15,15,15,15,15,15,5,6,6,7,15,15,15,15,15,15,15,15,15,15,15,15,15,15,15,15,15,15,15,15,15,15,15],
        [15,15,15,15,15,15,15,15,15,15,15,15,15,15,15,15,15,15,15,15,15,15,15,5,6,6,7,15,15,15,15,15,15,15,15,15,15,15,15,15,15,15,15,15,15,15,15,15,15,15],
        [15,15,15,15,15,15,15,15,15,15,15,15,15,15,15,15,15,15,15,15,15,15,15,5,6,6,7,15,15,15,15,15,15,15,15,15,15,15,15,15,15,15,15,15,15,15,15,15,15,15],
        [21,21,22,15,15,15,15,15,15,15,15,15,15,15,15,15,15,15,15,15,15,15,15,5,6,6,7,15,15,15,15,15,15,15,15,15,15,15,15,15,15,15,15,15,15,15,15,20,21,21],
        [24,24,25,15,15,15,15,15,15,15,15,15,15,15,15,15,15,15,15,15,15,15,15,5,6,6,7,15,15,15,15,15,15,15,15,15,15,15,15,15,15,15,15,15,15,15,15,23,24,24],
        [24,24,25,15,15,15,15,15,15,15,15,15,15,15,15,15,15,15,15,15,15,15,15,5,6,6,7,15,15,15,15,15,15,15,15,15,15,15,15,15,15,15,15,15,15,15,15,23,24,24],
        [24,24,25,15,15,15,15,15,15,15,15,15,15,15,15,15,15,15,15,15,15,15,15,5,6,6,7,15,15,15,15,15,15,15,15,15,15,15,15,15,15,15,15,15,15,15,15,23,24,24],
        [24,24,25,15,15,15,15,15,15,15,15,15,15,15,15,15,15,15,15,15,15,15,15,5,6,6,7,15,15,15,15,15,15,15,15,15,15,15,15,15,15,15,15,15,15,15,15,23,24,24],
        [24,24,25,15,15,15,15,15,15,15,1,1,1,1,1,1,1,1,1,1,15,15,15,5,6,6,7,15,15,15,1,1,1,1,1,1,1,1,1,1,15,15,15,15,15,15,15,23,24,24],
        [24,24,25,15,15,15,15,15,15,15,1,1,1,1,1,1,1,1,1,1,15,15,15,5,6,6,7,15,15,15,1,1,1,1,1,1,1,1,1,1,15,15,15,15,15,15,15,23,24,24],
        [24,24,25,15,15,15,15,15,15,15,1,1,1,1,1,1,1,1,1,1,15,15,15,5,6,6,7,15,15,15,1,1,1,1,1,1,1,1,1,1,15,15,15,15,15,15,15,23,24,24],
        [24,24,25,15,15,15,15,15,15,15,1,1,1,1,1,1,1,1,1,1,15,15,15,5,6,6,7,15,15,15,1,1,1,1,1,1,1,1,1,1,15,15,15,15,15,15,15,23,24,24],
        [24,24,25,15,15,15,15,15,15,15,1,1,1,1,1,1,1,1,1,1,15,15,15,5,6,6,7,15,15,15,1,1,1,1,1,1,1,1,1,1,15,15,15,15,15,15,15,23,24,24],
        [24,24,25,15,15,15,15,15,15,15,1,1,1,1,1,1,1,1,1,1,15,15,15,5,6,6,7,15,15,15,1,1,1,1,1,1,1,1,1,1,15,15,15,15,15,15,15,23,24,24],
        [24,24,25,15,15,15,15,15,15,15,1,1,1,1,1,1,1,1,1,1,15,15,15,5,6,6,7,15,15,15,1,1,1,1,1,1,1,1,1,1,15,15,15,15,15,15,15,23,24,24],
        [24,24,25,15,15,15,15,15,15,15,1,1,1,1,1,1,1,1,1,1,15,15,15,5,6,6,7,15,15,15,1,1,1,1,1,1,1,1,1,1,15,15,15,15,15,15,15,23,24,24],
        [24,24,25,15,15,15,15,15,15,15,1,1,1,1,1,1,1,1,1,1,15,15,15,5,6,6,7,15,15,15,1,1,1,1,1,1,1,1,1,1,15,15,15,15,15,15,15,23,24,24],
        [24,24,25,15,15,15,15,15,15,15,1,1,1,1,1,1,1,1,1,1,15,15,15,5,6,6,7,15,15,15,1,1,1,1,1,1,1,1,1,1,15,15,15,15,15,15,15,23,24,24],
        [24,24,25,15,15,15,15,15,15,15,15,15,15,15,15,15,15,15,15,15,15,15,15,5,6,6,7,15,15,15,15,15,15,15,15,15,15,15,15,15,15,15,15,15,15,15,15,23,24,24],
        [24,24,25,15,15,15,15,15,15,15,15,15,15,15,15,15,15,15,15,15,15,15,15,5,6,6,7,15,15,15,15,15,15,15,15,15,15,15,15,15,15,15,15,15,15,15,15,23,24,24],
        [24,24,25,15,15,15,15,15,15,15,15,15,15,15,15,15,15,15,15,15,15,15,15,5,6,6,7,15,15,15,15,15,15,15,15,15,15,15,15,15,15,15,15,15,15,15,15,23,24,24],
        [24,24,25,15,15,15,15,15,15,15,15,15,15,15,15,15,15,15,15,15,15,15,15,8,9,9,10,15,15,15,15,15,15,15,15,15,15,15,15,15,15,15,15,15,15,15,15,23,24,24],
        [24,24,25,15,15,15,15,15,15,15,15,15,15,15,15,15,15,15,15,15,15,15,15,15,15,15,15,15,15,15,15,15,15,15,15,15,15,15,15,15,15,15,15,15,15,15,15,23,24,24],
        [24,24,25,15,15,15,15,15,15,15,15,15,15,15,15,15,15,15,15,15,15,15,15,15,15,15,15,15,15,15,15,15,15,15,15,15,15,15,15,15,15,15,15,15,15,15,15,23,24,24],
        [24,24,25,15,15,15,15,15,15,15,15,15,15,15,15,15,15,15,15,15,15,15,15,15,15,15,15,15,15,15,15,15,15,15,15,15,15,15,15,15,15,15,15,15,15,15,15,23,24,24],
        [24,24,25,15,15,15,15,15,15,15,15,15,15,15,15,15,15,15,15,15,15,15,15,15,15,15,15,15,15,15,15,15,15,15,15,15,15,15,15,15,15,15,15,15,15,15,15,23,24,24],
        [24,24,25,15,15,15,15,15,15,15,15,15,15,15,15,15,15,15,15,15,15,15,15,15,15,15,15,15,15,15,15,15,15,15,15,15,15,15,15,15,15,15,15,15,15,15,15,23,24,24],
        [24,24,25,15,15,15,15,15,15,15,15,15,15,15,15,15,15,15,15,15,15,15,15,15,15,15,15,15,15,15,15,15,15,15,15,15,15,15,15,15,15,15,15,15,15,15,15,23,24,24],
        [24,24,25,15,15,15,15,15,15,15,1,1,1,1,1,1,1,1,1,1,15,15,15,20,21,21,22,15,15,15,1,1,1,1,1,1,1,1,1,1,15,15,15,15,15,15,15,23,24,24],
        [24,24,25,15,15,15,15,15,15,15,1,1,1,1,1,1,1,1,1,1,15,15,15,23,24,24,25,15,15,15,1,1,1,1,1,1,1,1,1,1,15,15,15,15,15,15,15,23,24,24],
        [24,24,25,15,15,15,15,15,15,15,1,1,1,1,1,1,1,1,1,1,15,15,15,23,24,24,25,15,15,15,1,1,1,1,1,1,1,1,1,1,15,15,15,15,15,15,15,23,24,24],
        [24,24,25,15,15,15,15,15,15,15,1,1,1,1,1,1,1,1,1,1,15,15,15,23,24,24,25,15,15,15,1,1,1,1,1,1,1,1,1,1,15,15,15,15,15,15,15,23,24,24],
        [24,24,25,15,15,15,15,15,15,15,1,1,1,1,1,1,1,1,1,1,15,15,15,23,24,24,25,15,15,15,1,1,1,1,1,1,1,1,1,1,15,15,15,15,15,15,15,23,24,24],
        [24,24,25,15,15,15,15,15,15,15,1,1,1,1,1,1,1,1,1,1,15,15,15,23,24,24,25,15,15,15,1,1,1,1,1,1,1,1,1,1,15,15,15,15,15,15,15,23,24,24],
        [24,24,25,15,15,15,15,15,15,15,1,1,1,1,1,1,1,1,1,1,15,15,15,23,24,24,25,15,15,15,1,1,1,1,1,1,1,1,1,1,15,15,15,15,15,15,15,23,24,24],
        [24,24,25,15,15,15,15,15,15,15,1,1,1,1,1,1,1,1,1,1,15,15,15,23,24,24,25,15,15,15,1,1,1,1,1,1,1,1,1,1,15,15,15,15,15,15,15,23,24,24],
        [24,24,25,15,15,15,15,15,15,15,1,1,1,1,1,1,1,1,1,1,15,15,15,23,24,24,25,15,15,15,1,1,1,1,1,1,1,1,1,1,15,15,15,15,15,15,15,23,24,24],
        [24,24,25,15,15,15,15,15,15,15,1,1,1,1,1,1,1,1,1,1,15,15,15,23,24,24,25,15,15,15,1,1,1,1,1,1,1,1,1,1,15,15,15,15,15,15,15,23,24,24],
        [27,27,28,15,15,15,15,15,15,15,15,15,15,15,15,15,15,15,15,15,15,15,15,23,24,24,25,15,15,15,15,15,15,15,15,15,15,15,15,15,15,15,15,15,15,15,15,26,27,27],
        [15,15,15,15,15,15,15,15,15,15,15,15,15,15,15,15,15,15,15,15,15,15,15,23,24,24,25,15,15,15,15,15,15,15,15,15,15,15,15,15,15,15,15,15,15,15,15,15,15,15],
        [15,15,15,15,15,15,15,15,15,15,15,15,15,15,15,15,15,15,15,15,15,15,15,23,24,24,25,15,15,15,15,15,15,15,15,15,15,15,15,15,15,15,15,15,15,15,15,15,15,15],
        [15,15,15,15,15,15,15,15,15,15,15,15,15,15,15,15,15,15,15,15,15,15,15,23,24,24,25,15,15,15,15,15,15,15,15,15,15,15,15,15,15,15,15,15,15,15,15,15,15,15],
        [15,15,15,15,15,15,15,15,15,15,15,15,15,15,15,15,15,15,15,15,15,15,15,23,24,24,25,15,15,15,15,15,15,15,15,15,15,15,15,15,15,15,15,15,15,15,15,15,15,15],
        [3,3,3,3,3,3,3,3,3,3,3,3,3,3,4,15,15,15,15,15,15,15,15,23,24,24,25,15,15,15,15,15,15,15,2,3,3,3,3,3,3,3,3,3,3,3,3,3,3,3],
        [6,6,6,6,6,6,6,6,6,6,6,6,6,6,7,15,15,15,15,15,15,15,15,23,24,24,25,15,15,15,15,15,15,15,5,6,6,6,6,6,6,6,6,6,6,6,6,6,6,6],
        [6,6,6,6,6,6,6,6,6,6,6,6,6,6,7,15,15,15,15,15,15,15,15,23,24,24,25,15,15,15,15,15,15,15,5,6,6,6,6,6,6,6,6,6,6,6,6,6,6,6],
        [6,6,6,6,6,6,6,6,6,6,6,6,6,6,7,15,15,15,15,15,15,15,15,23,24,24,25,15,15,15,15,15,15,15,5,6,6,6,6,6,6,6,6,6,6,6,6,6,6,6],
        [6,6,6,6,6,6,6,6,6,6,6,6,6,6,7,15,15,15,15,15,15,15,15,23,24,24,25,15,15,15,15,15,15,15,5,6,6,6,6,6,6,6,6,6,6,6,6,6,6,6]
    ],
    "startingX": 25,
    "startingY": 25
}
