{
    "width": 20,
    "height": 30,
    "data": [
        [24, 24, 24, 24, 25, 15, 15, 15, 15, 16, 6, 6, 6, 6, 11, 12, 12, 12, 12, 12, 12, 12, 12, 12, 12, 12, 12, 12, 12, 12],
        [24, 24, 24, 24, 25, 15, 15, 15, 15, 16, 6, 6, 6, 6, 14, 15, 15, 15, 15, 15, 1, 1, 1, 1, 1, 1, 1, 15, 20, 21],
        [24, 24, 24, 24, 25, 15, 15, 15, 15, 16, 6, 6, 6, 6, 14, 15, 15, 15, 15, 15, 1, 1, 1, 1, 1, 1, 1, 15, 23, 24],
        [27, 27, 27, 27, 28, 15, 15, 15, 15, 16, 6, 6, 6, 6, 14, 15, 15, 15, 15, 15, 1, 1, 1, 1, 1, 1, 1, 15, 23, 24],
        [15, 15, 15, 15, 15, 15, 15, 15, 15, 16, 6, 6, 6, 6, 14, 15, 15, 15, 15, 15, 1, 1, 1, 1, 1, 1, 1, 15, 23, 24],
        [18, 18, 18, 18, 18, 18, 18, 18, 18, 19, 6, 6, 6, 6, 14, 15, 15, 15, 15, 15, 15, 15, 15, 15, 15, 15, 15, 15, 23, 24],
        [6, 6, 6, 6, 6, 6, 6, 6, 6, 6, 6, 6, 6, 6, 14, 15, 15, 15, 15, 15, 15, 15, 15, 15, 15, 15, 15, 15, 23, 24],
        [6, 6, 6, 6, 6, 6, 6, 6, 6, 6, 6, 6, 6, 6, 14, 15, 15, 15, 15, 15, 15, 15, 15, 15, 15, 15, 15, 15, 23, 24],
        [6, 6, 6, 6, 6, 6, 6, 6, 6, 6, 6, 6, 6, 6, 14, 15, 15, 15, 15, 15, 15, 15, 15, 15, 15, 15, 15, 15, 23, 24],
        [6, 6, 6, 6, 6, 6, 6, 6, 6, 6, 6, 6, 6, 6, 14, 15, 15, 15, 15, 15, 15, 15, 15, 15, 15, 15, 15, 15, 23, 24],
        [6, 6, 6, 6, 6, 6, 6, 6, 6, 6, 6, 6, 6, 6, 14, 15, 15, 15, 15, 15, 15, 15, 15, 15, 15, 15, 15, 15, 23, 24],
        [6, 6, 6, 6, 6, 6, 6, 6, 6, 6, 6, 6, 6, 6, 14, 15, 15, 15, 15, 15, 15, 15, 15, 15, 15, 15, 15, 15, 23, 24],
        [12, 12, 12, 12, 12, 12, 12, 12, 12, 13, 6, 6, 6, 6, 14, 15, 15, 15, 15, 15, 15, 15, 15, 15, 15, 15, 15, 15, 23, 24],
        [1, 1, 1, 1, 1, 1, 1, 1, 1, 16, 6, 6, 6, 6, 14, 15, 15, 15, 15, 15, 15, 15, 15, 15, 15, 15, 15, 15, 23, 24],
        [1, 1, 1, 1, 1, 1, 1, 1, 1, 16, 6, 6, 6, 6, 14, 15, 15, 15, 15, 15, 1, 1, 1, 1, 1, 1, 1, 15, 23, 24],
        [1, 1, 1, 1, 1, 1, 1, 1, 1, 16, 6, 6, 6, 6, 14, 15, 15, 15, 15, 15, 1, 1, 1, 1, 1, 1, 1, 15, 23, 24],
        [15, 15, 15, 15, 15, 15, 15, 15, 15, 16, 6, 6, 6, 6, 14, 15, 15, 15, 15, 15, 1, 1, 1, 1, 1, 1, 1, 15, 23, 24],
        [15, 15, 15, 15, 15, 15, 15, 15, 15, 16, 6, 6, 6, 6, 14, 15, 15, 15, 15, 15, 1, 1, 1, 1, 1, 1, 1, 15, 23, 24],
        [15, 15, 15, 15, 15, 15, 15, 15, 15, 16, 6, 6, 6, 6, 14, 15, 15, 15, 15, 15, 1, 1, 1, 1, 1, 1, 1, 15, 26, 27],
        [15, 15, 15, 15, 15, 15, 15, 15, 15, 16, 6, 6, 6, 6, 17, 18, 18, 18, 18, 18, 18, 18, 18, 18, 18, 18, 18, 18, 18, 18]
    ]
}
